1111111111111111111111111111111111
1E0000000000000C00000C000000000001
1010010100100000101001000N00010101
1010010010101010N0100100N000010101
1P0000000C00C0000000000000000000C1
101001001010001N001001000000010101
101001N010001010001001000000010101
100000000000C00000000N000N000000C1
1010010010100010001001000000010101
1010010010001010001001000000010101
1000000N000000N0000000000000000001
1010N10010100010001001000000010101
1010010010001010001001000C00010101
1C00C00000000000000000000000000001
1010010010100010001001000000010101
1010010010001010001001000000010101
100000000000N0N00000N000000C000001
1111111111111111111111111111111111
