1111111111111111111111111111111111
1E0000000000000C00000C000000000001
1010010100100000101001000000010101
1010010010101010001001000000010101
1P0000000C00C0000000000000000000C1
1010010010100010001001000000010101
1010010010001010001001000000010101
100000000000C0000000000000000000C1
1010010010100010001001000000010101
1010010010001010001001000000010101
1000000N00000000000000000000000001
1010010010100010001001000000010101
1010010010001010001001000C00010101
1C00C00000000000000000000000000001
1010010010100010001001000000010101
1010010010001010001001000000010101
100000000000000000000000000C000001
1111111111111111111111111111111111
