11111
1P0C1
10001
10111
1E1C1
11111
