11111
1P0C1
10001
111C1
1E101
11111
