111111
100001
1C00C1
100001
1E00C1
111111
111111
